########E#######
#..........#...#
#.######.###.#.#
#.##...#..##.#.#
#....#..##.....#
##.#.########.##
##.#...........#
##.#.....S.....#
################